,,,,,,,,,,,,,,,,,,,,,,,,,,,,,,,,,,,,,,,,
,......................................,
,......................................,
,......................................,
,...#..................................,
,........@.....0.....0.................,
,........!......#...........#..........,
,........#............#................,
,...#..................................,
,,,,,,,,,,,,,,,,,,,,,,,,,,,,,,,,,,,,,,,,