.,.,.,.,.,.,.,.,.,.,.,.,.,.,.,.,.,`
,.,.,.,.,.,.,.,.,.,.,.,.,.,.,.,.,.`
.,.,.,.,.,.,.,.,.,.,.,.,.,.,.,.,.,`
,.,.,.,.,.,.,.,.,.,.,.,.,.,.,.,.,.`
.,.,.,.,.,.,.,.,.,.,.,.,.,#,.,.,.,`
,.,.,.,.,.,.,.,.,.,.,.,.,.,.,.,.,.`
.,.,.,.,.,.,.,.,.,.,.,.,.,.,.,.,.,`
,.,.,.,.,.,.,.,.,.,.,.,.,.,.,.,.,.`
.,.,.,.,@,.,.,.,.,.,.,.,.,.,.,.,.,`
,.,.,.,.!.,.,.,.,.,.,.,.,.,.,.,.,.`
.,.,.,.,.,.,.,.,.,.,.,.,.,.,.,.,.,`
,.,.,.,.,.,.,.,.,.,.,.,.,.,.,.,.,.`
.,.,.,.,.,.,.,.,.,.,.,.,.,.,.,.,.,`
,.,.,.,.,.,.,.,.,.,.,.,.,.,.,.,.,.`
.,.,.,.,.,.,.,.,.,.,.,.,.,.,.,.,.,`
,.,.,.,.,.,.,.,.,.,.,.,.,.,.,.,.,.`
.,.,.,.,.,.,.,.,.,.,.,.,.,.,.,.,.,`
```````````````````````````````````