.#.....................................
............#......#...................
....@...!......#...........#...........
........#............#.................
...#...................................
